11111111111111111111
1CPCCCCCC0CCC0CCCCE1
11111111111111111111