11111111111111111111
1CPCCCCCC0CCC0CCC0E1
11111111111111111111
